  #####                                    ###            #####                                           #
 #     #  ####  #    # #    #   ##   #   # ###  ####     #     #   ##   #    # ######     ####  ######    #       # ###### ######
 #       #    # ##   # #    #  #  #   # #   #  #         #        #  #  ##  ## #         #    # #         #       # #      #
 #       #    # # #  # #    # #    #   #   #    ####     #  #### #    # # ## # #####     #    # #####     #       # #####  #####
 #       #    # #  # # # ## # ######   #            #    #     # ###### #    # #         #    # #         #       # #      #
 #     # #    # #   ## ##  ## #    #   #       #    #    #     # #    # #    # #         #    # #         #       # #      #
  #####   ####  #    # #    # #    #   #        ####      #####  #    # #    # ######     ####  #         ####### # #      ######
